# nouns

tablo - table
fenestro - window
seĝo - chair
planko - floor
plafono - ceiling
bano - bath
lampo - lamp
lito - bed
glaso - glass
plumo - pen
floro - flower
suno - sun
homo - person

# nouns-animals

bovo - cow

# adjectives

seka - dry
varma - warm
granda - big
nova - new
larĝa - wide
kontenta - pleased, content
libera - free
pura - clean
forta - strong
sana - healthy
sankta - holy
proksima - near

# correlatives

kio - what (thing), in a general way
tio - that (thing), in a general way


# grammatical-endings

-a - adjective
-j - plural


# prefixes

mal- - opposite of    malfeliĉa - unhappy

# suffixes

-ar- - collection     birdaro - flock
