# nouns - days of the week

lundo - Monday
mardo - Tuesday
merkredo - Wednesday
ĵaŭdo - Thursday
vendredo - Friday
sabato - Saturday
dimanĉo - Sunday


# nouns - family

edzo - husband


# nouns

fajro - fire
homo - person
ranĉo - ranch
rano - frog


# pronouns

ri - he/she (subject) /  him/her (object of preposition)    (gender-neutral third person singular)
rin - him/her (object of verb)


# possessive adjectives

ria - his/her


# verbs

bezoni - to need
flugi - to fly
kredi - to believe   [credible, incredible, creed]


# adjectives

inteligenta - intelligent


# adverbs

malpli - less (used with ol)
malplej - least (used with el)


# correlatives

kiel - in what way, how
tiel - in that way, so
ĉi tiel - in this way
iel - in some way, somehow
ĉiel - in every way
neniel - in no way

