phrases

Saluton! - Hi!
Kiel vi fartas? - How are you?
Mi fartas bone. - I am well.
Bonvenon! - Welcome.

personal pronouns - as a subject

mi - I
vi - you (singular)
li - he
ŝi - she
ĝi - it
ni - we
vi - you (plural)
ili - they
oni - one

verbs (intransitive - do not take an object)

esti - to be
marŝi - to walk
farti - to fare
sidi - to sit
stari - to stand
iri - to go
veni - to come
dormi - to sleep

paroli - to speak
labori - to work
esperi - to hope
kuri - to run
vivi - to live
brili - to shine

nouns

viro - man
frato - brother
filo - son
patro - father
knabo - boy
avo - grandfather

domo - house
arbo - tree
kato - cat
hundo - dog
amiko - friend
birdo - bird
libro - book

adjectives

bela - beautiful
bona - good
juna - young
feliĉa - happy

suffixes

-in- - feminine    virino - woman
