# phrases

Diru al mi... - Tell me...
Mi petas - Please
Bonan matenon! - Good morning!
Bonan vesperon! - Good evening!
Bonan tagon! - Good day!
Bonan nokton! - Good night!


# adverbs

pli - more (used with ol)
plej - most (used with el)

# nouns

lumo - light (opposite of dark)   [illuminate, luminescent]

# verbs

opinii - to think, have an opinion
koni - to know, be acquainted with (persons, places)
scii - to know (facts)       [science]
farbi - to paint (a wall)    [refurbish]
pentri - to paint (a picture)    [paint]


# adjectives

kara - dear

unua - first
dua - second
tria - third
kvara - fourth
kvina - fifth
sesa - sixth
sepa - seventh
oka - eighth
naŭa - ninth
deka - tenth
centa - hundredth
mila - thousandth


# exclamations

do - so  (so, I went anyway)
nu - well  (well, I can't believe he said that)


# pronouns

ambaŭ - both    [ambidexterous, ambiguous, ambivalent]


# conjunctions

ke - that (joins two clauses)


# particles

ĉu ne - don't you?  isn't it?  didn't they?  right?


# prepositions

inter - between (if two), among (if more than two)
