adverbs

hodiaŭ - today
hieraŭ - yesterday
morgaŭ - tomorrow
nun - now
apenaŭ - barely
tre - very
jam - already
supre - above, up
malsupre - below, down
baldaŭ - soon
eĉ - even
ja - indeed
bele - beautifully
feliĉe - happily
forte - strongly
nove - newly
kontente - contentedly
libere - freely
bone - well - as in well done.  I fare well.  (you would think it was "good/ly", but no - 'well' is the adverb form of 'good' in English!)

correlatives

kie - where
tie - there

nouns

ŝafo - sheep
leono - lion
urso - bear
ĉevalo - horse
jaro - year
familio - family

adjectives

kvieta = quiet

suffixes

-an- - member of    urbano - member of city, citizen
-ido - offspring    bovido - calf
