-a - adjective
-aĉ- - contemptible, wretched     domaĉo - shack
-an- - member of      urbano - member of city, citizen
-ar- - collection     birdaro - flock
-as - present tense
-e - adverb
-ebl- - -able         legebla - legible
-eg- - much larger    virego - giant
-ej- - place          hundejo - doghouse
-et- - much smaller   dometo - cottage
-i - infinitive
-iĉ- - masculine      boviĉo - bull
-ido - offspring      bovido - calf
-ig- - to cause       mortigi - to kill
-il- - instrument     tranĉilo - knife
-in- - feminine       virino - woman
-ind- - worthy of     laŭdinda - praiseworthy
-is - past tense
-ist- - profession of person    instruisto - teacher
-j - plural
-n - object
-o - noun
-u - imperative (command)
-uj- - container      florujo - vase
-ul- - person         belulo - beautiful person
ĝi - it
ĝia - its
ĝin - it
ĝis - until
ĝusta - right, correct
ĉar - because
ĉe - at
ĉerizo - cherry
ĉevalo - horse   (mnenonic: cavalier)
ĉi tie - here (this place)
ĉi tio - this (thing), in a general way
ĉi tiu (with no noun) - this one, this one specifically
ĉi tiu /noun/ - this /noun/, this /noun/ specifically
ĉie - everywhere
ĉio - everything
ĉirkaŭ - around
ĉu - applied to sentence, makes it a yes or no question
ŝafo - sheep
ŝi - she
ŝia - her
ŝin - her
ŝultro - shoulder
aĉeti - to buy
aŭ - or
aŭdaca - bold  (mnenonic: audacious)
aŭtomobilo - automobile
akiri - to acquire, get
akvo - water     (aqua)
al - to
alia - other
ami - to love
amiko - friend
ankaŭ - also
antaŭ - before   (mnenonic: ante meridiem "AM")
apenaŭ - barely
apud - beside
arĝenta - silver
arbo - tree
avo - grandfather
baldaŭ - soon
bano - bath
bebo - baby
bela - beautiful
bele - beautifully
biero - beer
birdo - bird
blanka - white
blua - blue
bona - good
bone - well - as in well done.  I fare well.  (you would think it was "good/ly", but no - 'well' is the adverb form of 'good' in English!)
Bonvenon! - Welcome.
bovo - cow
brako - arm
brili - to shine
bruna - brown
buŝo - mouth
cent - hundred
Dankon! - Thank you!
de - from, since, by, of (possession)
dek - ten
demandi - to ask
dento - tooth
devi - to have (must, if present tense) - I have to do it
deziri - to desire
diri - to say, to tell
domo - house
doni - to give
dormi - to sleep
du - two
dum - during (while, as a conjunction)
dura - hard
eĉ - even
ekster - outside
el - out of
en - in
esperi - to hope
esplori - to explore
esti - to be
fali - to fall
familio - family
fari - to do, to make
farti - to fare
feliĉa - happy
feliĉe - happily
fenestro - window
fidi - to trust
filo - son
fingro - finger
flava - yellow
flegi - to nurse (a sick person)
floro - flower
forta - strong
forte - strongly
frato - brother   (mnenonic: fraternal)
frua - early
frunto - forehead
gambo - leg (thigh to foot)
genuo - knee
glaso - glass
granda - big
grava - important
griza - gray
halti - to stop
havi - to have
helpi - to help
herbo - grass
hieraŭ - yesterday
hodiaŭ - today
homo - person
hundo - dog
ie - somewhere
ili - they
ilia  - their
ilin - them
infano - child
instrui - to teach
io - something
iri - to go
ja - indeed
jam - already
jaro - year
je - at (time), or non-specific preposition
jes - yes
juna - young
kaj - and
kanti - to sing
kanto - song ("a singing")
kapo - head
kapti - to capture
kato - cat
kelkaj - few, some
kie - where (which place)
Kiel vi fartas? - How are you?
kio - what (thing), in a general way
kisi - to kiss
kiu (with no noun) - which one, which one specifically (or who, if you know it's a person)
kiu /noun/ - which /noun/, which /noun/ specifically
klara - clear
knabo - boy
kolo - neck
kompreni - to understand
kontenta - pleased, content
kontente - contentedly
koro - heart     (mnenonic: coronary)
korpo - body
krajono - pencil
kruro - shank (knee to foot)
kuŝi - to lie down
kubuto - elbow
kudri - to sew
kuiri - to cook
kun - with
kuri - to run
kuzo - cousin
kvankam - although
kvar - four   (mnenonic: quartet)
kvieta - quiet
kvin - five   (mnenonic: quintuplet)
la - the
labori - to work
lampo - lamp
larĝa - wide
legi - to read
leono - lion
lerni - to learn
li - he
lia - his
libera - free
libere - freely
libro - book
ligno - wood
lin - him
lingvo - language
lito - bed
ludi - to play
makzelo - jaw
mal- - opposite of
malsupre - below, down
manĝi - to eat
manki - to lack, to be absent, to be missing.  Vi mankas min.  You are missing to me = I miss you.
mano - hand
marŝi - to walk
mateno - morning
mentono - chin
mesaĝo - message
mezo - middle
mi - I
Mi fartas bone. - I am well.
mia - my
mil - thousand
min - me
miri - to be amazed, to marvel  (mnenonic: miracle)
misio - mission
momento - moment
monato - month
mondo - world
mono - money
morgaŭ - tomorrow
morti - to die
multa - much
naŭ - nine
nazo - nose
ne - no, does not (applied to verbs)
Nedankinde! - You're welcome!
nek - nor
nenie - nowhere
nenio - nothing
nepo - grandson   (mnenonic: nepotism)
nevo - nephew
ni - we
nia - our
nigra - black
nin - us
nokto - night    (mnenonic: nocturnal)
norda - north
nova - new
nove - newly
nulo - zero
nun - now
ok - eight
okcidenta - west
okulo - eye
ol - than
oni - one
onia - one's
onin - one
onklo - uncle
ora - gold
oranĝkolora - orange
orelo - ear
orienta - east
pagi - to pay
paroli - to speak
patro - father
pensi - to think
per - by (by means of)
piedfingro - toe
piedo - foot
plafono - ceiling
planko - floor
plena - full
plumo - pen
pomo - apple
por - for
porti - to carry
post - after, behind    (mnenonic: post meridiem "PM")
posttagmezo - afternoon
povi - to be able (can, if present tense)
preĝi - to pray
preni - to take
pri - about
programi - to program (a computer)
proksima - near
pura - clean
purpura - purple
rapida - fast
revuo - magazine
ricevi - to receive
ridi - to laugh
ruĝa - red
Saluton! - Hi!
sama - same
sana - healthy
sankta - holy
sata - sated, full   malsata - hungry
se - if
seĝo - chair
sed - but
seka - dry
semajno - week
sen - without
sep - seven
serĉi - to search for
ses - six
sidi - to sit
skribi - to write
stari - to stand
stranĝa - strange
strato - street
studento - student
stulta - stupid
sub - under, below
suda - south
sufiĉa - sufficient
suno - sun
super - over, above
supre - above, up
sur - on
tablo - table
tago - day
tie - there (that place)
tio - that (thing), in a general way
tiu (with no noun) - that one, that one specifically
tiu /noun/ - that /noun/, that /noun/ specifically
torto - pie
tra - through
tranĉi - to cut
tre - very
tri - three
unu - one
urbo - city
urso - bear
vango - cheek
varma - hot
vendi - to sell    (mnenonic: vendor)
veni - to come
vera - true   (mnenonic: veracity)
verda - green
vespero - evening   (mnenonic: vespers)
vi - you (plural)
vi - you (singular)
via - your (plural)
via - your (singular)
vidi - to see
vin - you (plural)
vin - you (singular)
viola - violet
viro - man      (mnenonic: virile)
vivi - to live
voli - to want
vorto - word
