ami - to love
brili - to shine
demandi - to ask
devi - to have (must, if present tense) - I have to do it
deziri - to desire
diri - to say, to tell
doni - to give
dormi - to sleep
esperi - to hope
esplori - to explore
esti - to be
fali - to fall
fari - to do, to make
farti - to fare
fidi - to trust
flegi - to nurse (a sick person)
halti - to stop
havi - to have
helpi - to help
instrui - to teach
iri - to go
kanti - to sing
kapti - to capture
kisi - to kiss
kudri - to sew
kuiri - to cook
kuri - to run
kuŝi - to lie down
labori - to work
legi - to read
lerni - to learn
manĝi - to eat
manki - to lack, to be absent, to be missing.  Vi mankas min.  You are missing to me = I miss you.
marŝi - to walk
morti - to die
pagi - to pay
paroli - to speak
pensi - to think
porti - to carry
povi - to be able (can, if present tense)
preĝi - to pray
preni - to take
programi - to program (a computer)
ridi - to laugh
serĉi - to search for
skribi - to write
sidi - to sit
stari - to stand
tranĉi - to cut
vendi - to sell    (vendor)
veni - to come
vidi - to see
vivi - to live
voli - to want
