-a - adjective
-aĉ- - contemptible, wretched     domaĉo - shack
-an- - member of      urbano - member of city, citizen
-ar- - collection     birdaro - flock
-as - present tense (verb)
-e - adverb
-ebl- - possible, -able      legebla - legible
-eg- - much larger    virego - giant
-ej- - place          hundejo - doghouse
-et- - much smaller   dometo - cottage
-i - infinitive (verb)
-iĉ- - masculine      boviĉo - bull
-ido - offspring      bovido - calf
-ig- - to cause       mortigi - to kill
-il- - instrument     tranĉilo - knife
-in- - feminine       virino - woman
-ind- - worthy of     laŭdinda - praiseworthy
-is - past tense (verb)
-ist- - profession of person    instruisto - teacher
-j - plural
-n - object
-o - noun
-u - imperative (command) (verb)
-uj- - container      florujo - vase
-ul- - person         belulo - beautiful person
ĝi - it
ĝia - its
ĝin - it (object of verb)
ĝis - until
ĝusta - right, correct
ĵaŭdo - Thursday     [Jupiter, jovial] 
ĉar - because
ĉe - at
ĉerizo - cherry
ĉevalo - horse   [cavalier]
ĉi tie - here (this place)
ĉi tiel - in this way
ĉi tio - this (thing), in a general way
ĉi tiu (with no noun) - this one, this one specifically
ĉi tiu /noun/ - this /noun/, this /noun/ specifically
ĉie - everywhere
ĉiel - in every way
ĉio - everything
ĉirkaŭ - around
ĉiu (with no noun) - everyone
ĉiu /noun/ - every /noun/
ĉu - applied to sentence, makes it a yes or no question
ĉu ne - isn't it, didn't they, etc (append to end of statement)
ŝafo - sheep
ŝi - she (subject) / her (object of preposition)
ŝia - her
ŝin - her (object of verb)
ŝultro - shoulder
aĉeti - to buy
aŭ - or
aŭdaca - bold    [audacious]
aŭtomobilo - automobile
ajn - -ever (with ki- words), any (with i- words)
akiri - to acquire, get
akvo - water     [aqua]
al - to
alia - other
ambaŭ - both     [ambidexterous, ambiguous, ambivalent]
ami - to love
amiko - friend
ankaŭ - also
antaŭ - before   [ante meridiem "AM"]
apenaŭ - barely
apud - beside
arĝenta - silver
arbo - tree
avo - grandfather
baldaŭ - soon
baleno - whale      [baleen]
bano - bath
bebo - baby
bela - beautiful
bele - beautifully
besto - animal      [beast]
bezoni - to need
biero - beer
bildo - picture
birdo - bird
blanka - white
blua - blue
bona - good
Bonan matenon! - Good morning!
Bonan nokton! - Good night!
Bonan tagon! - Good day!
Bonan vesperon! - Good evening!
bone - well - as in well done.  I fare well.  (you would think it was "good/ly", but no - 'well' is the adverb form of 'good' in English!)
Bonvenon! - Welcome.
bovo - cow
brako - arm
brili - to shine
bruna - brown
brusto - chest
buŝo - mouth
cent - hundred
centa - hundredth
cervo - deer
Dankon! - Thank you!
de - from, since, by, of (possession)
dek - ten       [decimal]
deka - tenth
demandi - to ask
dento - tooth
devi - to have (must, if present tense) - I have to do it
deziri - to desire
dimanĉo - Sunday   [dominica = Day of the Lord]
diri - to say, to tell
Diru al mi... - Tell me...
do - so  (so, I went anyway)
domo - house
doni - to give
dormi - to sleep
dorso - back       [dorsal fin]
du - two     [duet]
dua - second
dum - during (while, as a conjunction)
dura - hard
eĉ - even
edzo - husband
ekster - outside
el - out of
en - in
esperi - to hope
esplori - to explore
esti - to be
fajro - fire
fali - to fall
familio - family
farbi - to paint (a wall)    [refurbish]
fari - to do, to make
farti - to fare
feliĉa - happy
feliĉe - happily
fenestro - window
fidi - to trust
filo - son
fingro - finger
flava - yellow
flegi - to nurse (a sick person)
floro - flower
flugi - to fly
forta - strong
forte - strongly
Fraŭlino - Miss
Fraŭlo - Mr. (Bachelor)
frato - brother   [fraternal]
frua - early
frunto - forehead
gambo - leg (thigh to foot)
genuo - knee
glaso - glass
granda - big
grava - important
griza - gray
halti - to stop
havi - to have
helpi - to help
herbo - grass
hieraŭ - yesterday
hodiaŭ - today
homo - person
hundo - dog
ie - somewhere
iel - in some way, somehow
ili - they (subject) / them (object of preposition)
ilia  - their
ilin - them (object of verb)
infano - child
instrui - to teach
inteligenta - intelligent
inter - between (if two), among (if more than two)
io - something
iri - to go
iu (with no noun) - someone
iu /noun/ - some /noun/
ja - indeed
jam - already
jaro - year
je - on (date), at (time), -or- a non-specific preposition
jes - yes
juna - young
kaj - and
kanti - to sing
kanto - song ("a singing")
kapo - head
kapti - to capture
kara - dear
kato - cat
ke - that (joins two clauses)
kelkaj - few, some
kie - where (which place)
kiel - in what way, how
Kiel vi fartas? - How are you?
kio - what (thing), in a general way
kisi - to kiss
kiu (with no noun) - which one, which one specifically (or who, if you know it's a person)
kiu /noun/ - which /noun/, which /noun/ specifically
klara - clear
knabo - boy
kolo - neck
kompreni - to understand    [comprehend]
koni - to know, be acquainted with (persons, places)
kontenta - pleased, content
kontente - contentedly
koro - heart     [coronary]
korpo - body
krajono - pencil
kredi - to believe   [credible, incredible, creed]
kruro - shank (knee to foot)
kuŝi - to lie down
kubuto - elbow
kudri - to sew
kuiri - to cook
kun - with
kuri - to run
kuzo - cousin
kvankam - although
kvar - four   [quartet]
kvara - fourth
kvieta - quiet
kvin - five   [quintuplet]
kvina - fifth
la - the
labori - to work
lampo - lamp
larĝa - wide
legi - to read
leono - lion
lerni - to learn
li - he (subject) / him (object of preposition)
lia - his
libera - free
libere - freely
libro - book
ligno - wood
lin - him (object of verb)
lingvo - language
lito - bed
ludi - to play
lumo - light (opposite of dark)   [illuminate, luminescent]
lundo - Monday   [lunar, lunatic]
luno - moon      [lunar]
makzelo - jaw
mal- - opposite of
malplej - least (used with el)
malpli - less (used with ol)
malsupre - below, down
manĝi - to eat
manki - to lack, to be absent, to be missing.  Vi mankas min.  You are missing to me = I miss you.
mano - hand
marŝi - to walk
mardo - Tuesday   [Mars, Mardi Gras]
mateno - morning
mentono - chin
merkredo - Wednesday   [Mercury]
mesaĝo - message
mezo - middle
mi - I (subject) / me (object of preposition)
Mi fartas bone. - I am well.
Mi petas - Please
mia - my
mil - thousand
mila - thousandth
min - me (object of verb)
miri - to be amazed, to marvel  [miracle]
misio - mission
momento - moment
monato - month
mondo - world
mono - money
morgaŭ - tomorrow
morti - to die
multa - much (for uncountable things like water, salt, sand)
multaj - many (for countable things like miles, boys, fingers)
naŭ - nine
naŭa - ninth
nazo - nose
ne - no, does not (applied to verbs)
Nedankinde! - You're welcome!
nek - nor
nenie - nowhere
neniel - in no way
nenio - nothing
neniu (with no noun) - no one
neniu /noun/ - no /noun/
nepo - grandson   [nepotism]
nevo - nephew
ni - we (subject) / us (object of preposition)
nia - our
nigra - black
nin - us (object of verb)
nokto - night    [nocturnal]
norda - north
nova - new
nove - newly
nu - well  (well, I can't believe he said that)
nulo - zero
nun - now (nuna~present, current ("nowish"))
ok - eight    [octagon]
oka - eighth
okcidenta - west
okulo - eye
ol - than
oni - one
onia - one's
onin - one (object of verb)
onklo - uncle
opinii - to think, have an opinion
ora - gold
oranĝkolora - orange
orelo - ear
orienta - east
pagi - to pay
paroli - to speak
patro - father
pensi - to think   [pensive]
pentri - to paint (a picture)    [paint]
per - by (by means of)
piedfingro - toe
piedo - foot
plafono - ceiling
planko - floor
plej - most (used with el)
plena - full
pli - more (used with ol)
plumo - pen
pomo - apple
por - for
porti - to carry
post - after, behind    [post meridiem "PM"]
posttagmezo - afternoon
povi - to be able (can, if present tense)
preĝi - to pray
preni - to take
preskaŭ - almost
pri - about
programi - to program (a computer)
proksima - near
pura - clean
purpura - purple
ranĉo - ranch
rano - frog
rapida - fast
revuo - magazine
ri - he/she (subject) /  him/her (object of preposition)    (gender-neutral third person singular)
ria - his/her
ricevi - to receive
ridi - to laugh
rin - him/her (object of verb)
ruĝa - red
sabato - Saturday   [sabbath]
Saluton! - Hi!
sama - same
sana - healthy
sankta - holy
sata - sated, full   malsata - hungry
scii - to know (a fact)       [science]
se - if
seĝo - chair
sed - but
seka - dry
semajno - week
sen - without
sep - seven
sepa - seventh
serĉi - to search for
ses - six
sesa - sixth
sidi - to sit
Sinjorino - Mrs.
Sinjoro - Mr.
skribi - to write
stari - to stand
stelo - star     [stellar]
stranĝa - strange
strato - street
studento - student
stulta - stupid
sub - under, below
suda - south
sufiĉa - sufficient
suno - sun
super - over, above
supre - above, up
sur - on
tablo - table
tago - day
tero - land or Earth     [subterranean]
tie - there (that place)
tiel - in that way, so
tio - that (thing), in a general way
tiu (with no noun) - that one, that one specifically
tiu /noun/ - that /noun/, that /noun/ specifically
torto - pie
tra - through
tranĉi - to cut
tre - very
tri - three
tria - third
unu - one    [unity, union, unify]
unua - first
urbo - city
urso - bear
vango - cheek
varma - hot
vendi - to sell    [vendor]
vendredo - Friday    [Venus]
veni - to come
vento - wind     [vent]
ventro - belly     [ventral fin]
vera - true   [veracity]
verda - green
vespero - evening   [vespers]
vi - you (plural)
vi - you (singular)
via - your (plural)
via - your (singular)
vidi - to see
vin - you (plural) (object of verb)
vin - you (singular) (object of verb)
viola - violet
viro - man      [virile]
vivi - to live
voli - to want
vorto - word
