alia - other
aŭdaca - bold  (mnenonic: audacious)
bela - beautiful
bona - good
dura - hard
feliĉa - happy
forta - strong
frua - early
granda - big
grava - important
ĝusta - right, correct
juna - young
kelkaj - few, some
klara - clear
kontenta - pleased, content
kvieta - quiet
libera - free
larĝa - wide
multa - much
norda - north
nova - new
okcidenta - west
orienta - east
plena - full
proksima - near
pura - clean
rapida - fast
sama - same
sana - healthy
sankta - holy
sata - sated, full   malsata - hungry
seka - dry
stulta - stupid
suda - south
sufiĉa - sufficient
stranĝa - strange
varma - hot
vera - true   (mnenonic: veracity)
