# personal-pronouns

me - I/me               +
vu - you (singular)     +
lu - he/him/she/her/it  +

ni - we/us              :
vi - you (plural)       :
li - they/them          +

onu - one {one does what one can}  +

# grammatical-endings

-as - present tense (verb)  :

# verbs

standas - fares      +
sidas - sits         :
stacas - stands      +
dormas - sleeps      :
parolas - speaks     :
laboras - works      :
esperas - hopes      :
vivas - lives        :
brilas - shines      :

# nouns-animals

urso - bear       :
ucelo - bird      +

# adjectives

bela - beautiful  :
bona - good       :
yuna - young      :
felica - happy    +

# nouns-family                                  MOVE SOME LATER!!

muliero - woman     +

frato - sibling     +
fratulo - brother   +{fraternal}
fratino - sister    :

filio - son/daughter    +
filiulo - son           +
filiino - daughter      +
                        
avo - grandparent       +
avulo - grandfather     +
avino - grandmother     :
                        
genitoro - parent       +
patro - father          :
matro - mother          +

puero - child (8 - 15 years)   +
puerulo - boy (8 - 15 years)   +
puerino - girl (8 - 15 years)  +

# phrases                                     LATER

Saluto! - Hello!                   :
Bonveno! - Welcome!                :
Quale vu standas? - How are you?   +
Me standas bone. - I am well.      +

# suffixes

-ul - male        fratulo - brother  +
-in - female      fratino - sister   :
