jaro - year
ĉerizo - cherry
torto - pie
tago - day
misio - mission
mondo - world
momento - moment
kanto - song ("a singing")
nokto - night    [nocturnal]
strato - street
koro - heart     [coronary]
herbo - grass
akvo - water     [aqua]
biero - beer
mateno - morning
mesaĝo - message
vespero - evening   [vespers]
mezo - middle
posttagmezo - afternoon
revuo - magazine
monato - month
semajno - week
lumo - light (opposite of dark)   [illuminate, luminescent]
fajro - fire
ranĉo - ranch
rano - frog
bildo - picture
luno - moon      [lunar]
tero - land or Earth     [subterranean]
stelo - star     [stellar]
vento - wind     [vent]
domo - house
arbo - tree
amiko - friend
libro - book
paco - peace
ĉemizo - shirt
pantalono - pants
lago - lake
pluvo - rain   (whence: pluvi - to rain)
neĝo - snow   (whence: neĝi - to snow)
reĝo - king   (whence: reĝino - queen)
odoro - odor
boato - boat
tablo - table
fenestro - window
seĝo - chair
planko - floor
plafono - ceiling
bano - bath
lampo - lamp
lito - bed
glaso - glass
plumo - pen
floro - flower
suno - sun
homo - person
lingvo - language     [lingual]
pomo - apple
studento - student
dento - tooth
urbo - city
mono - money
krajono - pencil
ligno - wood
aŭtomobilo - automobile
vorto - word
